50
DDDDDDDDDDDDDDDDDDDDDDDDRRRRDDDDDDDDDDDDDDDDDDDDDD
DDDDDDDDDDDDDDDDDDDDDDDDRRRRDDDDDDDDDDDDDDDDDDDDDD
DDDDDDDDDDDDDDDDDDDDDDDDRRRRDDDDDDDDDDDDDDDDDDDDDD
DDDDDDDDDDDDDDDDDDDDDDDDRRRRDDDDDDDDDDDDDDDDDDDDDD
DDDDDDDDDDDDDDDDDDDDDDDDRRRRDDDDDDDDDDDDDDDDDDDDDD
DDDDDDDDDDDDDDDDDDDDDDDDRRRRDDDDDDDDDDDDDDDDDDDDDD
DDDDDDDDDDDDDDDDDDDDDDDDRRRRDDDDDDDDDDDDDDDDDDDDDD
DDDDDDDDDDDDDDDDDDDDDDDDRRRRDDDDDDDDDDDDDDDDDDDDDD
DDDDDDDDDDDDDDDDDDDDDDDDRRRRDDDDDDDDDDDDDDDDDDDDDD
DDDDDDDDDDDDDDDDDDDDDDDDRRRRDDDDDDDDDDDDDDDDDDDDDD
DDDWWWWWWWWWWWWWWWWWWDDDRRRRDDDDDDDDDDDDDDDDDDDDDD
DDDWRRRRRRRRRRRRRRRRWDDDRRRRDDDDDDDDDDDDDDDDDDDDDD
DDDWRRRRRRRRRRRRRRRRWDDDRRRRDDDDDDDDDDDDDDDDDDDDDD
DDDWRRRRRRRRRRRRRRRRWDDDRRRRDDDDDDDDDDDDDDDDDDDDDD
DDDWRRRRRRRRRRRRRRRRRRRRRRRRDDDDDDDDDDDDDDDDDDDDDD
DDDWRRRRRRRRRRRRRRRRRRRRRRRRDDDDDDDDDDDDDDDDDDDDDD
DDDWRRRRRRRRRRRRRRRRWDDDRRRRDDDDDDDDDDDDDDDDDDDDDD
DDDWRRRRRRRRRRRRRRRRWDDDRRRRDDDDDDDDDDDDDDDDDDDDDD
DDDWRRRRRRRRRRRRRRRRWDDDRRRRDDDDDDDDDDDDDDDDDDDDDD
DDDWWWWWWWWWWWWWWWWWWDDDRRRRDDDDDDDDDDDDDDDDDDDDDD
DDDDDDDDDDDDDDDDDDDDDDDDRRRRDDDDDDDDDDDDDDDDDDDDDD
DDDDDDDDDDDDDDDDDDDDDDDDRRRRDDDDDDDDDDDDDDDDDDDDDD
DDDDDDDDDDDDDDDDDDDDDDDDRRRRDDDDDDDDDDDDDDDDDDDDDD
DDDDDDDDDDDDDDDDDDDDDDDDRRRRDDDDDDDDDDDDDDDDDDDDDD
DDDDDDDDDDDDDDDDDDDDDDDDRRRRDDDDDDDDDDDDDDDDDDDDDD
RRRRRRRRRRRRRRRRRRRRRRRRRRRRRRRRRRRRRRRRRRRRRRRRRR
RRRRRRRRRRRRRRRRRRRRRRRRRRRRRRRRRRRRRRRRRRRRRRRRRR
RRRRRRRRRRRRRRRRRRRRRRRRRRRRRRRRRRRRRRRRRRRRRRRRRR
DDDDDDDDDDDDDDDDDDDDDDDDRRRRDDDDDDDDDDDDDDDDDDDDDD
DDDDDDDDDDDDDDDDDDDDDDDDRRRRDDDDDDDDDDDDDDDDDDDDDD
DTTDDDDTTDDDDDDDDDDDDDDDRRRRDDDDDDDDDDDDDDDDDDDDDD
DTTDDDDTTDDDDDDDDDDDDDDDRRRRDDDDDDDDDDDDDDDDDDDDDD
DDDDDDDDDDDDDDDDDDDDDDDDRRRRDWWWWWWWWWWWWWWWWWWWWW
DDDDDDDDDDDDDDDDDDDDDDDDRRRRDWRRRRRRRRRRRRRRRRRRRW
DTTDDDDTTDDDDDDDDDDDDDDDRRRRDWRRRRRRRRRRRRRRRRRRRW
DTTDDDDTTDDDDDDDDDDDDDDDRRRRDWRRRRRRRRRRRRRRRRRRRW
DDDDDDDDDDDDDDDDDDDDDDDDRRRRDWRRRRRRRRRRRRRRRRRRRW
DTTDDDDTTDDDDDDDDDDDDDDDRRRRDWRRRRRRRRRRRRRRRRRRRW
DTTDDDDTTDDDDDDDDDDDDDDDRRRRDWRRRRRRRRRRRRRRRRRRRW
DDDDDDDDDDDDDDDDDDDDDDDDRRRRDWRRRRRRRRRRRRRRRRRRRW
DTTDDDDTTDDDDDDDDDDDDDDDRRRRDWRRRRRRRRRRRRRRRRRRRW
DTTDDDDTTDDDDDDDDDDDDDDDRRRRDWRRRRRRRRRRRRRRRRRRRW
DDDDDDDDDDDDDDDDDDDDDDDDRRRRDWWWWWWWWWWWWWWWWWWRRW
DTTDDDDTTDDDDDDDDDDDDDDDRRRRDDDDDDDDDDDDDDDDDDDRRD
DTTDDDDTTDDDDDDDDDDDDDDDRRRRRRRRRRRRRRRRRRRRRRRRRR
DDDDDDDDDDDDDDDDDDDDDDDDRRRRRRRRRRRRRRRRRRRRRRRRRR
DDDDDDDDDDDDDDDDDDDDDDDDRRRRRRRRRRRRRRRRRRRRRRRRRR
DDDDDDDDDDDDDDDDDDDDDDDDRRRRRRRRRRRRRRRRRRRRRRRRRR
DDDDDDDDDDDDDDDDDDDDDDDDRRRRDDDDDDDDDDDDDDDDDDDDDD
DDDDDDDDDDDDDDDDDDDDDDDDRRRRDDDDDDDDDDDDDDDDDDDDDD
