60
DDDDDDDDDDDDDDDDDDDDDDDDRRRRDDDDDDDDDDDDDDDDDDDDDDDDDDDDDDDD
DDDDDDDDDDDDDDDDDDDDDDDDRRRRDDDDDDDDDDDDDDDDDDDDDDDDDDDDDDDD
DDWWWWWWWWWWWWWWWWWWWDDDRRRRDDDDDDDDDDDDDDDDDDDDDDDDDDDDDDDD
DDWRRRRRRRRRRRRRRRRRWDDDRRRRDDDDDDDDTDDDDDDDDTDDDDDDDDDDDDDD
DDWRRRRRRRRRRRRRRRRRWDDDRRRRDDDDDDDDDDDDDDDTDDDDDDTDDTDDDDDD
DDWRRRRRRRRRRRRRRRRRWDDDRRRRDDDDDTDDDDDDDDDDDDDDTDDDDDDDDDDD
DDWRRRRRRRRRRRRRRRRRWDDDRRRRDDDDDDDDDDDDDTDDTDDDDDDDDDDDDDDD
DDWRRRRRRRRRRRRRRRRRWDDDRRRRDDDDDDDDDDDDDDDDDDDDDDDTDDDDDDDD
DDWRRRRRRRRRRRRRRRRRWDDDRRRRDDDTDDDDDTDDDDDDDDDDDTDDDDDDDDDD
DDWRRRRRRRRRRRRRRRRRWDDDRRRRDDDDDDDDDDDDDDDDDTDDDDDDDDDDDDDD
DDWRRRRRRRRRRRRRRRRRWDDDRRRRDDDDDDTDDDDDDDDDDDDTDDDDDDDDDDDD
DDWRRRRRRRRRRRRRRRRRWDDDRRRRDDDDDDDDDDDDDDDDDDDDDDDDDDDDDDDD
DDWRRRRRRRRRRRRRRRRRWDDDRRRRDDDDDDDDDDTDDDDDDDDDDTDDDDDDDDDD
DDWRRRRRRRRRRRRRRRRRWDDDRRRRDDDDDTDDDDDDDDDDDTDDDDDDDDDDDDDD
DDWRRRRRRRRRRRRRRRRRWDDDRRRRDDDTDDDDDDDDDDDDDDDDDDDDDDDDDDDD
DDWRRRRRRRRRRRRRRRRRWDDDRRRRDDDDDDDDDDDDDDDDDDTDDDDDDDDDDDDD
DDWRRRRRRRRRRRRRRRRRWDDDRRRRDDDDDDDDTDDDDDDDDDDDDDDDDDDDDDDD
DDWRRRRRRRRRRRRRRRRRWDDDRRRRDDDDDDDDDDDDDDDDDDDDDDDDDDDDDDDD
DDWRRRRRRRRRRRRRRRRRRRRRRRRRDDDDDDDDDDDDDDDDDDDDDDDDDDDDDDDD
DDWRRRRRRRRRRRRRRRRRRRRRRTRRDDDDDTDDDDDDDDDDDDDDDDDDDDDDDDDD
DDWWWWWWWWWWWWWWWWWWWDDDRRRRDDDDDDDDDDDDDDDDDDDDDDDDDDDDDDDD
DDDDDDDDDDDDDDDDDDDDDDDDRRRTDDDDDDDDTDDDDDDDDDDDDDDDDDDDDDDD
DDDDDDDDDDDDDDDDTDDDDDDDRRRRDDDDDTDDDDDDDDDDDDDDDDDDDDDDDDDD
DDDDDDDDDDDDDDDDDDTDDDDDRRRRRRRRRRRRRRRRRRRRRRDDDDDDDDDDDDDD
DDDDDDDDDDDDDWWWWWWWWWWWWWDDWWWWWWWWWWWWWWWRRRDDDDDDDDDDDDDD
DDDDDDDDDDDDDWWWWWWWWWWWDDDDWWWWWWWWWWWWWWWRRRDDDDDDDDDDDDDD
DDDDDDDDDDDDDWWWWWWWWWWWDDWWWWWWWWWWWWWWWWWRRRDDDDDDDDDDDDDD
DDDDDDDDDDDDDWWWWWWWWWWWDDDDWWWWWWWWWWWWWWWRRRDDDDDDDDDDDDDD
DDDDDDDDDDDDDWWWWWWWWWWWWWDDWWWWWWWWWWWWWWWRRRDDDDDDDDDDDDDD
DDDDDDDDDDDDDWWWWWWWWWWWDDDDWWWWWWWWWWWWWWWRRRDDDDDDDDDDDDDD
DDDDDDDDDDDDDWWWWWWWWWWWDDWWWWWWWWWWWWWWWDDRRRDDDDDDDDDDDDDD
DDDDDDDDDDDDDWWWWWWWWWWWDDDDWWWWWWWWWWWWDDDRRRDDDDDDDDDDDDDD
DDDDDDDDDDDDDWWWWWWWWWWWWWDDWWWWWWWWWWWDDDWRRRDDDDDDDDDDDDDD
DDDDDDDDDDDDDWWWWWWWWWWWDDDDWWWWWWWWWWDDDWWRRRDDDDDDDDDDDDDD
DDDDDDDDDDDDDWWWWWWWWWWWDDWWWWWWWWWWWDDDWWWRRRDDDDDDDDDDDDDD
DDDDDDDDDDDDDWWWWWWWWWWWDDDDWWWWWWWWWDDWWWWRRRDDDDDDDDDDDDDD
DDDDDDDDDDDDDDDDDDDDDDDDRRRRRRRRRRRRRRRRRRRRRRDDDDDDDDDDDDDD
DDDDDDDDDDDDDDDDDDDDDDDDRRRRRRRRRRRRRRRRRRRRRRDDDDDDDDDDDDDD
DDDDDDDDDDDDDDDDDDDDDDDDRRRRDDDDDDDDDDDDDDDDDDDDDDDDDDDDDDDD
DDWWWWWWWWWWWWWWWWWWWWWWRRRRWWWWWWWWWWWWWWWWWWWWWWWWWWWWWWDD
DDWRRRRRRRRRRRRRRRRRRRRWRRRRRRRRRRRRRRRRRRRRRRRRRRRRRRRRRWDD
DDWRRRRRRRRRRRRRRRRRRRRWRRRRRRRRRRRRRRRRRRRRRRRRRRRRRRRRRWDD
DDWRRRRRRRRRRRRRRRRRRRRWRRRRRWRRRRRRRRRRRRRRRRRRRRRRRRRRRWDD
DDWRRRRRRRRRRRRRRRRRRRRWRRRRRWRRRRRRRRRRRRRRRRRRRRRRRRRRRWDD
DDWRRRRRRRRRRRRRRRRRRRRRRRRRRWwwwwwwwwwwwwwwwwwwwwwwwwwwRWDD
DDWRRRRRRRRRRRRRRRRRRRRRRRRRRWRRRRRRRRRRRRRRRRRRRRRRRRRRRWDD
DDWWWWWWWWWWWWWWWWWWWWWWRRRRRWRRRRRRRRRRRRRRRRRRRRRRRRRRRWDD
DDWRRRRRRRRRRRRRRRRRRRRRRRRRRWRWWWWWWWWWWWWWWWWWWWWWWWWWWWDD
DDWRRRRRRRRRRRRRRRRRRRRRRRRRRWRRRRRRRRRRRRRRRRRRRRRRRRRRRWDD
DDWRRRRRRRRRRRRWWWRWWWWWRRRRRWRRRRRRRRRRRRRRRRRRRRRRRRRRRWDD
DDWRRRRRRRRRRRRWRRRRRRRWRRRRRWWWWWWWWWWWWWWWWWWWWWWWWWWWWWDD
DDWRRRRRRRRRRRRWRRRRRRRWRRRRRRRRRRRRRRRRRRRRRRRRRRRRRRRRRWDD
DDWRRRRRRRRRRRRRRRRRRRRRRRRRRWRWWWRWWWRWWwRWWWRWWWRWWWRWWWDD
DDWRRRRRRRRRRRRWRRRRRRRWRRRRRWRRRWRRRWRRRwRRRWRRRWRRRWRRRWDD
DDWRRRRRRRRRRRRWRRRRRRRWRRRRRWRRRWRRRWRRRwRRRWRRRWRRRWRRRWDD
DDWRRRRRRRRRRRRWWWWWWWWWRRRRRWRRRWRRRWRRRwRRRWRRRWRRRWRRRWDD
DDWRRRRRRRRRRRRRRRRRRRRWRRRRRWRRRWRRRWRRRwRRRWRRRWRRRWRRRWDD
DDWWWWWWWWWWWWWWWWWWWWWWWWWWWWWWWWWWWWWWWWWWWWWWWWWWWWWWWWDD
DDDDDDDDDDDDDDDDDDDDDDDDDDDDDDDDDDDDDDDDDDDDDDDDDDDDDDDDDDDD
DDDDDDDDDDDDDDDDDDDDDDDDDDDDDDDDDDDDDDDDDDDDDDDDDDDDDDDDDDDD
