60
DDDDDDDDDDDDDDDDDDDDDDDDRRRRDDDDDDDDDDDDDDDDDDDDDDDDDDDDDDDD
DDDDDDDDDDDDDDDDDDDDDDDDRRRRDDDDDDDDDDDDDDDDDDDDDDDDDDDDDDDD
DDWWWWWWWWWWWWWWWWWWWDDDRRRRDDDDDDDDDDDDDDDDDDDDDDDDDDDDDDDD
DDWRRRRRRRRRRRRRRRRRWDDDRRRRDDDDDDDDTDDDDDDDDTDDDDDDDDDDDDDD
DDWRRRRRRRRRRRRRRRRRWDDDRRRRDDDDDDDDDDDDDDDTDDDDDDTDDTDDDDDD
DDWRRRRRRRRRRRRRRRRRWDDDRRRRDDDDDTDDDDDDDDDDDDDDTDDDDDDDDDDD
DDWRRRRRRRRRRRRRRRRRWDDDRRRRDDDDDDDDDDDDDTDDTDDDDDDDDDDDDDDD
DDWRRRRRRRRRRRRRRRRRWDDDRRRRDDDDDDDDDDDDDDDDDDDDDDDTDDDDDDDD
DDWRRRRRRRRRRRRRRRRRWDDDRRRRDDDTDDDDDTDDDDDDDDDDDTDDDDDDDDDD
DDWRRRRRRRRRRRRRRRRRWDDDRRRRDDDDDDDDDDDDDDDDDTDDDDDDDDDDDDDD
DDWRRRRRRRRRRRRRRRRRWDDDRRRRDDDDDDTDDDDDDDDDDDDTDDDDDDDDDDDD
DDWRRRRRRRRRRRRRRRRRWDDDRRRRDDDDDDDDDDDDDDDDDDDDDDDDDDDDDDDD
DDWRRRRRRRRRRRRRRRRRWDDDRRRRDDDDDDDDDDTDDDDDDDDDDTDDDDDDDDDD
DDWRRRRRRRRRRRRRRRRRWDDDRRRRDDDDDTDDDDDDDDDDDTDDDDDDDDDDDDDD
DDWRRRRRRRRRRRRRRRRRWDDDRRRRDDDTDDDDDDDDDDDDDDDDDDDDDDDDDDDD
DDWRRRRRRRRRRRRRRRRRWDDDRRRRDDDDDDDDDDDDDDDDDDTDDDDDDDDDDDDD
DDWRRRRRRRRRRRRRRRRRWDDDRRRRDDDDDDDDTDDDDDDDDDDDDDDDDDDDDDDD
DDWRRRRRRRRRRRRRRRRRWDDDRRRRDDDDDDDDDDDDDDDDDDDDDDDDDDDDDDDD
DDWRRRRRRRRRRRRRRRRRRRRRRRRRDDDDDDDDDDDDDDDDDDDDDDDDDDDDDDDD
DDWRRRRRRRRRRRRRRRRRRRRRRTRRDDDDDTDDDDDDDDDDDDDDDDDDDDDDDDDD
DDWWWWWWWWWWWWWWWWWWWDDDRRRRDDDDDDDDDDDDDDDDDDDDDDDDDDDDDDDD
DDDDDDDDDDDDDDDDDDDDDDDDRRRTDDDDDDDDTDDDDDDDDDDDDDDDDDDDDDDD
DDDDDDDDDDDDDDDDTDDDDDDDRRRRDDDDDTDDDDDDDDDDDDDDDDDDDDDDDDDD
DDDDDDDDDDDDDDDDDDTDDDDDRRRRDDDDDDDDDDDDDDDDDDDDDDDDDDDDDDDD
DDDDDDDDDDDDDWWWWWWWWWWWWWWWWWWWWWWWWWWWWWWRRRDDDDDDDDDDDDDD
DDDDDDDDDDDDDWWWWWWWWWWWWWWWWWWWWWWWWWWWWWWRRRDDDDDDDDDDDDDD
DDDDDDDDDDDDDWWWWWWWWWWWWWWWWWWWWWWWWWWWWWWRRRDDDDDDDDDDDDDD
DDDDDDDDDDDDDWWWWWWWWWWWWWWWWWWWWWWWWWWWWWWRRRDDDDDDDDDDDDDD
DDDDDDDDDDDDDWWWWWWWWWWWWWWWWWWWWWWWWWWWWWWRRRDDDDDDDDDDDDDD
DDDDDDDDDDDDDWWWWWWWWWWWWWWWWWWWWWWWWWWWWWWRRRDDDDDDDDDDDDDD
DDDDDDDDDDDDDWWWWWWWWWWWWWWWWWWWWWWWWWWWWDDRRRDDDDDDDDDDDDDD
DDDDDDDDDDDDDWWWWWWWWWWWWWWWWWWWWWWWWWWWDDDRRRDDDDDDDDDDDDDD
DDDDDDDDDDDDDWWWWWWWWWWWWWWWWWWWWWWWWWWDDDWRRRDDDDDDDDDDDDDD
DDDDDDDDDDDDDWWWWWWWWWWWWWWWWWWWWWWWWWDDDWWRRRDDDDDDDDDDDDDD
DDDDDDDDDDDDDWWWWWWWWWWWWWWWWWWWWWWWWDDDWWWRRRDDDDDDDDDDDDDD
DDDDDDDDDDDDDWWWWWWWWWWWWWWWWWWWWWWWWDDWWWWRRRDDDDDDDDDDDDDD
DDDDDDDDDDDDDDDDDDDDDDDDRRRRRRRRRRRRRRRRRRRRRRDDDDDDDDDDDDDD
DDDDDDDDDDDDDDDDDDDDDDDDRRRRRRRRRRRRRRRRRRRRRRDDDDDDDDDDDDDD
DDDDDDDDDDDDDDDDDDDDDDDDRRRRDDDDDDDDDDDDDDDDDDDDDDDDDDDDDDDD
DDWWWWWWWWWWWWWWWWWWWWWWRRRRWWWWWWWWWWWWWWWWWWWWWWWWWWWWWWDD
DDWRRRRRRRRRRRRRRRRRRRRWRRRRRRRRRRRRRRRRRRRRRRRRRRRRRRRRRWDD
DDWRRRRRRRRRRRRRRRRRRRRWRRRRRRRRRRRRRRRRRRRRRRRRRRRRRRRRRWDD
DDWRRRRRRRRRRRRRRRRRRRRWRRRRRWRRRRRRRRRRRRRRRRRRRRRRRRRRRWDD
DDWRRRRRRRRRRRRRRRRRRRRWRRRRRWRRRRRRRRRRRRRRRRRRRRRRRRRRRWDD
DDWRRRRRRRRRRRRRRRRRRRRRRRRRRWwwwwwwwwwwwwwwwwwwwwwwwwwwRWDD
DDWRRRRRRRRRRRRRRRRRRRRRRRRRRWRRRRRRRRRRRRRRRRRRRRRRRRRRRWDD
DDWWWWWWWWWWWWWWWWWWWWWWRRRRRWRRRRRRRRRRRRRRRRRRRRRRRRRRRWDD
DDWRRRRRRRRRRRRRRRRRRRRRRRRRRWRWWWWWWWWWWWWWWWWWWWWWWWWWWWDD
DDWRRRRRRRRRRRRRRRRRRRRRRRRRRWRRRRRRRRRRRRRRRRRRRRRRRRRRRWDD
DDWRRRRRRRRRRRRRRRRRRRRWRRRRRWRRRRRRRRRRRRRRRRRRRRRRRRRRRWDD
DDWRRRRRRRRRRRRRRRRRRRRWRRRRRWWWWWWWWWWWWWWWWWWWWWWWWWWWWWDD
DDWRRRRRRRRRRRRRRRRRRRRWRRRRRRRRRRRRRRRRRRRRRRRRRRRRRRRRRWDD
DDWRRRRRRRRRRRRRRRRRRRRWRRRRRWRWWWRWWWRWWwRWWWRWWWRWWWRWWWDD
DDWRRRRRRRRRRRRRRRRRRRRWRRRRRWRRRWRRRWRRRwRRRWRRRWRRRWRRRWDD
DDWRRRRRRRRRRRRRRRRRRRRWRRRRRWRRRWRRRWRRRwRRRWRRRWRRRWRRRWDD
DDWRRRRRRRRRRRRRRRRRRRRWRRRRRWRRRWRRRWRRRwRRRWRRRWRRRWRRRWDD
DDWRRRRRRRRRRRRRRRRRRRRWRRRRRWRRRWRRRWRRRwRRRWRRRWRRRWRRRWDD
DDWWWWWWWWWWWWWWWWWWWWWWWWWWWWWWWWWWWWWWWWWWWWWWWWWWWWWWWWDD
DDDDDDDDDDDDDDDDDDDDDDDDDDDDDDDDDDDDDDDDDDDDDDDDDDDDDDDDDDDD
DDDDDDDDDDDDDDDDDDDDDDDDDDDDDDDDDDDDDDDDDDDDDDDDDDDDDDDDDDDD
